{
  "width": 50,
  "height": 10,
  "spawn": {
    "x": 0,
    "y": 8
  },
  "platforms": [
    { "x": 0, "y": 9 },
    { "x": 1, "y": 9 },
    { "x": 2, "y": 9 },
    { "x": 3, "y": 9 },
    { "x": 4, "y": 8 },
    { "x": 5, "y": 7 },
    { "x": 6, "y": 6 },
    { "x": 7, "y": 5 },
    { "x": 8, "y": 4 },
    { "x": 9, "y": 3 }
  ]
}