{
  "width": 50,
  "height": 10,
  "spawn": {
    "x": 0,
    "y": 8
  },
  "objects": {
    "exit": [
      { "x": 48, "y": 8 }
    ],
    "platform": [
      { "x": 0, "y": 9 },
      { "x": 1, "y": 9 },
      { "x": 2, "y": 9 },
      { "x": 4, "y": 8 },
      { "x": 6, "y": 7 },
      { "x": 8, "y": 6 },
      { "x": 10, "y": 5 },
      { "x": 12, "y": 4 },
      { "x": 14, "y": 3 },
      { "x": 16, "y": 4 },
      { "x": 18, "y": 5 },
      { "x": 20, "y": 6 },
      { "x": 22, "y": 7 },
      { "x": 24, "y": 8 },
      { "x": 26, "y": 9 },
      { "x": 27, "y": 9 },
      { "x": 28, "y": 9 },
      { "x": 29, "y": 9 },
      { "x": 30, "y": 9 },
      { "x": 31, "y": 9 },
      { "x": 32, "y": 9 },
      { "x": 33, "y": 9 },
      { "x": 34, "y": 9 },
      { "x": 35, "y": 9 },
      { "x": 36, "y": 9 },
      { "x": 37, "y": 9 },
      { "x": 38, "y": 9 },
      { "x": 39, "y": 9 },
      { "x": 40, "y": 9 },
      { "x": 41, "y": 9 },
      { "x": 42, "y": 9 },
      { "x": 43, "y": 9 },
      { "x": 44, "y": 9 },
      { "x": 45, "y": 9 },
      { "x": 46, "y": 9 },
      { "x": 47, "y": 9 },
      { "x": 48, "y": 9 },
      { "x": 49, "y": 9 }
    ],
    "coin": [
      { "x": 4, "y": 7 },
      { "x": 6, "y": 6 },
      { "x": 8, "y": 5 },
      { "x": 10, "y": 4 },
      { "x": 12, "y": 3 },
      { "x": 14, "y": 2 },
      { "x": 16, "y": 3 },
      { "x": 18, "y": 4 },
      { "x": 20, "y": 5 },
      { "x": 22, "y": 6 },
      { "x": 24, "y": 7 },
      { "x": 28, "y": 8 },
      { "x": 31, "y": 8 },
      { "x": 34, "y": 8 },
      { "x": 37, "y": 8 },
      { "x": 40, "y": 8 },
      { "x": 43, "y": 8 },
      { "x": 46, "y": 8 }
    ]
  }
}