{
  "width": 12,
  "height": 10,
  "spawn": {
    "x": 6,
    "y": 8
  },
  "objects": {
    "platform": [
      { "x": 0, "y": 9 },
      { "x": 1, "y": 9 },
      { "x": 2, "y": 9 },
      { "x": 3, "y": 9 },
      { "x": 4, "y": 9 },
      { "x": 5, "y": 9 },
      { "x": 6, "y": 9 },
      { "x": 7, "y": 9 },
      { "x": 8, "y": 9 },
      { "x": 9, "y": 9 },
      { "x": 10, "y": 9 },
      { "x": 11, "y": 9 }
    ],
    "wall": [
      { "x": 2, "y": 8 },
      { "x": 2, "y": 7 },
      { "x": 2, "y": 6 },
      { "x": 9, "y": 8 },
      { "x": 9, "y": 7 },
      { "x": 9, "y": 6 }
    ],
    "exit": [
      { "x": 11, "y": 8 }
    ]
  }
}